111111111111111
100000000000001
1P0110000000001
100000000000001
10000C0C0CC0001
10000CCC0CC0001
10000C0C0C00001
100000000000001
100000000000001
100000000E00001
111111111111111