111111111111111
10P00C0C00C00E1
111111111111111