111111111111111
10P000C000000E1
11111111111111