111111111111111
100P0000C0000E1
111111111111111