111111111111111
100P0000C00E001
111111111111111
