111111111111111111
1000P0000000E00001
100000000000000001
100000C000000000C1
111111111111111111