11111111111
1PCCCCCCCC1
1CCCCCCCCC1
1CCCCCCCCC1
1CCCCCCCCC1
1CCCCCCCCC1
1CCCCCCCCC1
1CCCCCCCCC1
1CCCCCCCCC1
1CCCCCCCCE1
11111111111