111111111111111
1X0PCC0000000E1
111111111111111