111111111111111111
1P0000C00000000001
100000000000000001
10000000000X0000E1
111111111111111111