111111111111111111
1P0000C00000000001
10000000X00X000001
10000000X00X0000E1
111111111111111111